BBBBBBBBBBBBBBBB
B..............B
B.GGGGGG...RR..B
B..............B
B.GGGGGG...RR..B
B..............B
B.GGGGGG...RR..B
B..............B
B.GGGGGG...RR..B
B..............B
B.GGGGGG...RR..B
B..............B
B.GGGGGG...RR..B
B..............B
B..............B
B..............B
B..............B
B..............B
B..........789.B
B.FFFFFF...456.B
B.FFFFFF...123.B
B..........<0E.B
B..............B
BBBBBBBBBBBBBBBB
